5 10
0 1 1 1 1 1 1 1 1 0
0 1 4 2 2 2 3 4 1 0
0 1 3 2 3 3 3 4 1 0
0 1 2 2 4 4 1 5 1 0
0 1 1 1 1 1 1 1 1 0
