10 10
1 1 1 1 1 1 1 1 1 1
1 2 2 2 2 2 2 2 2 1
1 2 1 1 2 1 2 1 2 1
1 2 1 1 2 3 3 1 2 1
1 2 1 1 2 1 2 1 2 1
1 4 2 2 3 2 3 2 2 1
1 6 1 1 2 1 2 1 2 1
1 4 1 1 2 1 2 1 2 1
1 7 4 6 4 2 2 3 2 1
1 1 1 1 1 1 1 1 1 1
