6 6
1 1 1 1 1 1
1 4 3 2 4 1
1 2 2 6 3 1
1 3 2 5 2 1
1 4 2 3 4 1
1 1 1 1 1 1
