5 5
1 1 1 1 1
1 4 3 5 1
1 1 1 1 1
0 0 0 0 0
0 0 0 0 0
